########
##__@###
##$#_$_#
#_.._._#
#___$__#
###$#.##
###___##
########