##############
#..__#_____###
#..__#_$__$__#
#..__#$####__#
#..____@_##__#
#..__#_#__$_##
######_##$_$_#
###_$__$_$_$_#
###____#_____#
##############