########
###___##
#.@$__##
###_$.##
#.##$_##
#_#_._##
#$_*$$.#
#___.__#
########